0 0 0 0 0 0 0 0 0 0 0 0 0 0 0 0 0 0 0
0 1 1 1 1 1 1 0 0 1 1 1 0 0 1 1 1 1 0
0 1 1 S 1 1 7 4 4 1 6 4 4 1 3 3 2 0 0
0 1 1 1 1 1 1 0 0 1 1 1 0 0 1 1 1 1 0
0 0 0 0 0 0 1 1 1 1 0 0 0 0 0 0 0 0 0
0 0 0 0 0 0 1 5 1 1 0 0 0 0 0 0 0 0 0
0 0 0 0 0 0 1 1 1 1 0 0 0 0 0 0 0 0 0

BRIDGE b1 2 7 2 8
BRIDGE b2 2 11 2 12
SWITCH 5 7 SOFT TOGGLE b1
SWITCH 2 10 HEAVY TOGGLE b2
SPLIT 2 6 2 2 5 6