0 0 0 0 0 0 0 0 0 0 0 0 0 0 0 0 0 0 0 0
0 1 1 1 1 1 1 0 0 1 1 1 1 0 0 1 1 1 1 0
0 1 1 S 1 1 6 4 4 1 1 5 1 4 4 1 3 3 2 0
0 1 1 1 1 1 1 0 0 1 1 1 1 0 0 1 1 1 1 0
0 0 0 0 0 0 0 0 0 0 0 0 0 0 0 0 0 0 0 0

BRIDGE b1 2 7 2 8
BRIDGE b2 2 13 2 14
SWITCH 2 6 HEAVY TOGGLE b1
SWITCH 2 11 SOFT TOGGLE b2