0 0 0 0 0 0 0 0 0 0 0 0 0 0
0 1 1 1 1 1 1 1 0 0 1 1 1 1
0 1 1 S 1 1 5 1 4 4 1 3 3 2
0 1 1 1 1 1 1 1 0 0 1 1 1 1
0 0 0 0 0 0 0 0 0 0 0 0 0 0

BRIDGE b1 2 8 2 9
SWITCH 2 6 SOFT TOGGLE b1