1 1 1 1 1 1 1 1 1
1 1 1 7 1 1 4 1 2
1 1 S 1 1 1 1 1 1
1 1 1 1 1 1 1 1 1

BRIDGE b1 1 6
SWITCH 2 5 SOFT TOGGLE b1
SPLIT 1 3 1 2 2 4
